###############################B#############################
#     #                     #   #         #         #       #
# ##### ############### ### # # # ####### # ### ### # ### # #
#   #   #         #   # # #   # #   #   #   #   #   # #   # #
### # ##### ### # # ### # ##### ### # # ##### ##### ### ### #
#   #     #   # #   #   #     # #   # # #   #     #     #   #
# ####### ##### ### # ### ### # # ### ### # ##### ####### ###
# #         #   #   # # # # #   # #   #   #     #   #     # #
# # ####### # ##### # # # # ##### # # # ####### ### # ##### #
#     #   #   #   # # # # #   #   # # # #   #   #   #   #   #
####### # ##### # ### # # # # # ##### # # # # ### ##### ### #
#   #   #     # #   # # # # # # #   #   # # #   # #   #     #
# # # ####### # ### # # # # # # # # # ### # ### # # # ##### #
# #   #     #   #   # #     # #   # # # # #     #   #     # #
# ##### ### ##### ### ####### ##### # # # ##### ######### ###
#     #   #     # #       #   #   # # # # #   # #       #   #
# ### ### ##### # # ##### ##### # # # # # ### # # # ####### #
# #   # #     #   #   # #     # # # #   #   # #   # #       #
# # ### ##### ####### # ##### # # # ####### # ##### # ##### #
# #   #     #     # # # #     # #   #       #       #   #   #
# ### # ######### # # # # ##### ##### ####### ######### #####
# # # #       #   #   # # #   # #     #   #   # #     #     #
# # # # ### ### ### ### # # # # # ##### ### ### # ### ### # #
#   # #   # #   #       # # #   #     #   #   # # #     # # #
### # ##### # ####### ### # ######### ### ### # # ##### ### #
#   #     #     #   # #   #   #     #   #   #   # #   # #   #
######### ##### # # ### ##### ### # ### # ##### # # # # # # #
#       #   # #   #   #     #   # # #   #       #   # #   # #
# ##### # # # ####### ### # ### # # # ########### ### #######
# #   # # # # #       #   #   # # #   #         #   # #     #
# # ### # # # # ####### ##### # # ##### ####### ##### # ### #
# #   # # # #   #   #     #   # #     # #   #   #     #   # #
# # # # ### # ### # ##### # ### # ### # # # # ### ####### ###
# # #       #     #       # #   # #   # # # # #   #     # # #
# # ########### ########### # ##### ### # ### ### # ### # # #
# # #   #       #         # #       #   #         # # # # # #
# ### # ####### # ####### # ####### # ######### ### # # # # #
#   # # #     # # # #     #     #   # #     #   #   # #   # #
# # # # # ### # # # # ########### ### # ### ### # ### ##### #
# #   # # #   # # # #   #       # #   #   #   # #     #     #
# ##### # # ##### # ### # ##### # # ##### ### ####### # ### #
# #   #   #   #   #   #   #   #   #       # #         #   # #
# # # ####### # ### # ####### ############# ############# ###
# # #       #   # # #       #       #     #             #   #
# ### ##### ##### # # ##### # ### ### # ### ######### # # # #
#     #   #     #   # #   # # #   #   #   #   #       # # # #
######### ##### ### # # # # # # # # ##### ### # ####### ### #
#       #     #   # # # # # # # # # #   #   # # #     # #   #
# ##### # # ##### ### # ### # # # # # ### # # # ### # # # # #
# #   # # #     # #   # #   # # # # #   # # # # #   # #   # #
# # ### # ##### # # ### # ### # ### ### # ### # # ### ##### #
# #   # # #     #   #     # # #   # #   # #   # #   #   #   #
# ### # ### ### ##### ##### # ### # # # # # ### # # ### # ###
#   # # #   #       #     # #   #     # #   #   # # # # #   #
### # # # ############### # # ##### ######### ### # # # ### #
#   # #   #     #     #   #   #   # #   #   #   # # #     # #
# ### ### # ### # ### # ##### # # ### # # # ### ### ####### #
#   #     #   #   # #   #   # # #     #   #   #   # #     # #
# # ######### ##### ##### # ### ############# ### # # ### # #
# #                       #     #                 #     #   #
###############################A#############################