################################################### #################################################
#A                #   #     #       #   #             #     #           #   #         #       #     #
######### ####### # # # # # ### ##### # # ####### ### # ### # ##### ### # # # ####### # ##### # ### #
#         #       # # # # #   # #     #   #     #   #   # # # #     # #   # # #     #   #   # #   # #
# ######### ####### ### # ### # # ######### ### ### ##### # ### ##### ##### # # ### ##### ### ##### #
#       #     #     #   # # #   # #       #   #   #   #     #   #     #     # # # #   #   #   #     #
# ##### ##### # ### # ### # ### # # ##### ### ### # # ##### # ### # ### ##### # # ### # ### ### ### #
# #     #   #   #   #   # #     # #     #     #   # #     # # #   #   # #   # # #   # #     #     # #
# # ##### # ### ####### # ### ### ##### ####### ### ##### # # # ##### # # # # # ### # # ##### ### # #
# # #     # # # #       #   #   # #   #     #   #     #   #   # #     # # # #   #   # # # #   # # # #
# # # ##### # # # ######### ##### # ####### # ### ##### # ##### # ##### # # ### # # # # # # ### # # #
# #   # #   # # #   #   # #     # # #       #   # #     # #   # #     #   #   #   # # # # #     # # #
# ##### # ### # ### # # # ##### # # # ######### ### ####### # # ##### ####### # ##### # # ##### # ###
# #   # #   # #   #   # #     #     #   #     #   # #   #   # #     #     # # # #     # #       #   #
# # # # ### # ### ##### ### # ######### # ### ### # # # # ### ####### ### # # ### ##### ########### #
#   #     # #     #   #     #   #   #   # #   # # #   #     #   #     # #   # #   #   #           # #
####### ### # ####### ######### # # # ### ### # # ### ######### # ##### # ### # # # # ########### # #
#   #   #   #   #   # #         # # #   #   #   #   #     #     #   #     #   # # # #           #   #
### # ### ##### # # # # ######### # ### # # ####### ##### # ####### # ##### ### # # ########### #####
#   # # # #       #   #   #       #     # #   #     #     #   #     # #   # #   # #   #   #   #     #
# ### # # # ############# # ##### ####### ### # ##### ##### # ### # ### # # ### ##### # # # # ##### #
#       # #   #           # #     #     # #   # #   # #   # # #   # #   # #   #   #     # # #       #
# ####### # ### ########### ### ### ### ### ### # # ### # ### # ##### ### ### # # # ####### ####### #
# #       # #   #         #   #   #   #   #       #     #     # #     #   #   # #   #     # #     # #
### ##### ### ########### ### ####### ### # ################### # ##### ### ### ##### ### # ##### # #
#   #   # #   #     #       #   #     #   #   #   #           #   # #   #   # # # #   #     #     # #
# ### # ### ### ### # ##### ### # ##### ##### # # ### ######### ### # ### ### # # # ######### # ### #
# #   #   # #   #   #     #   # #   # #   #   # #   #   #       #   #     #   # # #       #   # #   #
# # ##### # ### # ##### # ### # ### # ### # ### ### # # # ####### # ####### # # # ####### ### ### ###
#   #   #   #   #     # # #   #         # #   # # # # #         # #   #     # #   #     #   # #   # #
# ### ####### ####### # # ############# # ##### # # ########### # ### ### # # ### # ####### # # ### #
# #           # #     # #   #         # # #       #   #   #       #     # # #   #   #       # #     #
# ##### ##### # # ####### # # ####### ### # ######### # # ############# ### ####### # ####### ##### #
#     # #     #   #     # # # #     #     #   #       # #             # #   #   #   #   #   #       #
##### # # ##### ##### # ### # ### ####### ### # ##### # ######### ### # # ### # # ##### # # # #######
# #   # #     #       #     #   #       #   # #   #   # # #     # #   # #     #     #   # #   #     #
# # ### ##### ################# # ### ### ### ### ##### # # ### ### ### # ########### ### ####### # #
#   #   #   # #     #           #   #     #   # #         #   #   # # # #   #       # # # #       # #
# ### ##### # # ### # # ############# ##### ### ############# ### # # # ##### ##### # # # ### ##### #
# # #       #   #   # # #           #   #   #           #   #   # # #         #   #   #   #   #     #
# # # ######### # # # ### ######### # ### ####### ####### # ### # # ########### # ##### ### ##### ###
# #   #       # # # #     #         # #   #       #       #     # #   #       # #       #       #   #
# ##### ##### # # # ####### ####### ### ### # ##### ############# ### # ##### # ############### #####
#       #   # # # # #     # #     # #   # # # #     #         # # #   #     #   #   #         #     #
####### # # # ### # # ##### # # ### # ### # # # ##### ####### # # # ####### ##### # # # ##### ### # #
#     # # # #     #   #     # # #   # #   # # #     # # #   # # #   #     # #     # # # #   #   # # #
# ##### # # ########### ##### ### ### ### # # ##### # # # # # # ##### # ### # # ### ### # # ### ### #
#   #   # # #       #   #       # # #   #   #     #   # # #   #     # # #   # # # #   # # #   #   # #
# # # ### # # ##### # # ####### # # ### # ### ### ##### # ##### ### # # # ### # # ### # # ### ### # #
# # #   # #   #       # #     #   #   # #   # #       # #   #   # #   #   #   # #   # # #   #   #   #
### ### # ##### ######### ### # ##### # ##### ####### # ### # ### ######### ### ### # # # # ####### #
# # #   #     # #         #   #       #     # #   #       # #           #   #   #   #   # #   #     #
# # # ####### # # ######### ######### ##### # # # # ####### ########### ##### ### ########### # #####
# #         # # #         #   #       #   # # # # # #   #   #   #     #     # #   #           #   # #
# ######### # ### ##### ##### ### ####### # # # # ### # # # # # # ### ##### # # # # ##### # ##### # #
#         # #     #   # #   #   #   #   # # #   #   # #   # # #   # # #   #   # #   # #   # #     # #
######### ######### # ### # ### ### # # # # ### ### # ### ### ##### # ### ##### ##### # ### # ##### #
#       #           #     # #   # #   #   #   # #   #   # #   #     #   #   #   #     # #   #   #   #
####### ################### # ### ####### ### # # ##### ### ### ####### # # # ##### ### # ##### ### #
#           #   #           # #     #   # #   # #   #   #   #   #       # #     #   #   #     # #   #
# ##### ##### # # ########### ### ### # # # ### ### # ### ### ### ####### ##### # ### ######### # ###
# # #   #     #   # #         #   #   # # #   #   # #       # #   #       #   # #   #   #       #   #
# # # ### ######### # ### ##### # # ### # ### # ### ####### # # ##### ##### # # ### ### # ######### #
# #     # #             # # #   # #   #     # # #   #     # # #     #   #   # #     #   # #       # #
# # ##### # ############# # # # ##### ####### ### # # ### # # ##### # ### ### ####### ### ### ### # #
# # # #   #     #   #     #   #       #           # #   # #       # # #   #   #     #   # #   #     #
# # # # ##### ### # # ####### ####### # ############### # ####### # # # ### ### ### ### # # ### #####
# # # #     # #   #   #     # #     # #     # #         #       # # # # # #     # # #   # # #   #   #
# # # ##### ### # ##### ### ### ### ####### # # ############### # # ### # ####### # # ### # ### # # #
# #   #     #   # #     # #   # # #     #     # # #         #   # #   #   #     # # # #   #   # # # #
# ##### ##### ##### ##### ### # # ### # # ##### # # ####### # ### ### ### # ### # # # # ### # ### # #
# #     # #   #     #     #   #   #   # #   #   # # #     # #   #   #     # #     # #   #   #     # #
# # ##### # # # ##### ##### # ### # ####### # ### # # ##### ### ### ####### ##### # ### ##### ##### #
# #     #   #     #     #   # # # #         # #   #   #     #   # # #           # #   #     #   #   #
# ##### ######### # ### # ### # # ########### # ##### # ### # ### # ########### # ### ##### ### # ###
#     #   #   # # #   # # #     # # #         #     # # #   # #   #     #       # # #   #     # #   #
# # ##### # # # # ##### # ##### # # # ######### # ### # ### # # ####### # ####### # ### ##### ##### #
# #     #   # # #       #   #   #   # #   #     #     #   # # # #     # #   #   #   # #     #       #
# ##### ##### # # ####### # ####### # # ### ############# ### # # ### # ### ### ### # ##### ####### #
#     #   #   #   #     # # #       # # #   #     #     # #   #     # #   #   #   #   #     #   #   #
##### # # # ####### ### # # # ####### # # ### ### ### # # # ### ##### ### ### # ##### # ##### # # ###
#     # # #         #   # #   #   #   #   #   # #     # #   #   #     # # #   #       #   #   # # # #
# ##### ############# ######### # # ### ### ### ####### ######### ### # # # ### ######### ### ### # #
# #   #     #       # #       # #   # # #   #       #   # #     #   #   # # #   #   #   #   #     # #
# # ##### # ####### # # ##### # ##### # # ####### ### ### # # # # # ##### # # ### # # ##### # ##### #
# # #     #       # #   #   #   #     # # #     #   # #     # # # #     #   #     #   #     #       #
# # # ########### # ##### ####### # ### # # ### # # # ####### # # ##### ############# # ########### #
#   # #   #   # #       #     #   # #   #   #   # # #         # #   # #         #     # # #       # #
# ### # # # # # ####### # ### # ### # ####### ##### ########### ### # ######### # ##### # # ##### # #
# #   # #   # #         # # #     # #   #     #   # #   #     #   #           #   #   # # #   # #   #
# # ### ##### # ##### ### # ####### ### # ##### # # # # # ### ### ##### ##### ##### # # # ### # #####
# #       #   # #   # #       #   #   # #       # # # #   #     # #     #   #   #   #   #   #   #   #
# ######### ### # # # # ####### # # # # ##### ### # # ##### ##### ####### # ##### ####### # ### # # #
#     #     #   # # # #   #   # # # # #     # #   # #   # #       #   #   # #   # #   #   #   # # # #
##### # ######### # # # ### # # # # # ##### ### ### ### # ######### # # ### # # # # # # # ### # ### #
#   # #         # # # # #   #   # # #     # #   #       #     #     #   # #   # #   # # #   # # #   #
# # # ######### # # # ### ####### # ####### # ### ####### ### # ######### ##### ##### ##### # # # ###
# # #   #   #   # # #     #     #   #     # #   # #       # # # #       #     #       #     # # #   #
# ##### ### # ### # ####### ### ##### ### # ### # # ####### # # # ####### # ########### ####### ### #
#           #     #           #         #       #   #           #         #                        B#
################################################### #################################################