#########
#### #B #
###  #  #
##   #  #
##      #
## # # ##
## # # ##
#       #
####A####