###                 #########
#   ###################   # #
# ####                # # # #
# ################### # # # #
#                     # # # #
##################### # # # #
#   ##                # # # #
# # ## ### ## ######### # # #
# #    #   ##B#         # # #
# # ## ################## # #
### ##             ###### # #
### ############## ## ### # #
###             ##    ### # #
###### ######## ######### # #
###### ####                 #
A      ######################